2 2 2 2 2 2 2 2 2 2 2 2 2 2 2 2 2 2 2 2 2 2 2 2 2 2 2 2 2 2 2 2 2 2 2 2 2 2 2 2 2 2 2 2 2 2 2 2 2 2 2 2 2 2 2 2 2 2 2 2 2 2 2 2 2 2 2 2 2 2 2 2 2 2 2 2 2 2 2 2 2 2 2 2 2 2 2 2 2 2 2 2 2 2 2 2 2 2 2 2
2 2 2 2 2 2 2 2 2 2 2 2 2 2 2 2 2 2 2 2 2 2 2 2 2 2 2 2 2 2 2 2 2 2 2 2 2 2 2 2 2 2 2 2 2 2 2 2 2 2 2 2 2 2 2 2 2 2 2 2 2 2 2 2 2 2 2 2 2 2 2 2 2 2 2 2 2 2 2 2 2 2 2 2 2 2 2 2 2 2 2 2 2 2 2 2 2 2 2 2
3 3 3 3 3 3 3 3 3 3 3 3 3 3 3 3 3 3 3 3 3 3 3 3 3 3 3 3 3 3 3 3 3 3 3 3 3 3 3 3 3 3 3 3 3 3 3 3 3 3 3 3 3 3 3 3 3 3 3 3 3 3 3 3 3 3 3 3 3 3 3 3 3 3 3 3 3 3 3 3 3 3 3 3 3 3 3 3 3 3 3 3 3 3 3 3 3 3 3 3
3 3 3 3 3 3 3 3 3 3 3 3 3 3 3 3 3 3 3 3 3 3 3 3 3 3 3 3 3 3 3 3 3 3 3 3 3 3 3 3 3 3 3 3 3 3 3 3 3 3 3 3 3 3 3 3 3 3 3 3 3 3 3 3 3 3 3 3 3 3 3 3 3 3 3 3 3 3 3 3 3 3 3 3 3 3 3 3 3 3 3 3 3 3 3 3 3 3 3 3
3 3 3 3 3 3 3 3 3 3 3 3 3 3 3 3 3 3 3 3 3 3 3 3 3 3 3 3 3 3 3 3 3 3 3 3 3 3 3 3 3 3 3 3 3 3 3 3 3 3 3 3 3 3 3 3 3 3 3 3 3 3 3 3 3 3 3 3 3 3 3 3 3 3 3 3 3 3 3 3 3 3 3 3 3 3 3 3 3 3 3 3 3 3 3 3 3 3 3 3
3 3 3 3 3 3 3 3 3 3 3 3 3 3 3 3 3 3 3 3 3 3 3 3 3 3 3 3 3 3 3 3 3 3 3 3 3 3 3 3 3 3 3 3 3 3 3 3 3 3 3 3 3 3 3 3 3 3 3 3 3 3 3 3 3 3 3 3 3 3 3 3 3 3 3 3 3 3 3 3 3 3 3 3 3 3 3 3 3 3 3 3 3 3 3 3 3 3 3 3
1 1 0 0 0 0 0 0 0 0 0 5 0 0 5 0 0 0 0 5 0 5 0 5 0 5 5 5 0 0 0 0 0 0 0 0 0 0 0 0 5 0 0 5 0 0 0 0 5 0 5 0 5 0 5 5 5 0 0 0 0 0 0 0 0 0 0 0 0 5 0 0 5 0 0 0 0 5 0 5 0 5 0 5 5 5 0 0 0 0 0 0 0 0 0 0 0 0 1 1
1 1 0 0 0 0 0 0 0 0 0 5 0 0 5 0 0 0 0 5 0 5 0 5 0 5 5 5 0 0 0 0 0 0 0 0 0 0 0 0 5 0 0 5 0 0 0 0 5 0 5 0 5 0 5 5 5 0 0 0 0 0 0 0 0 0 0 0 0 5 0 0 5 0 0 0 0 5 0 5 0 5 0 5 5 5 0 0 0 0 0 0 0 0 0 0 0 0 1 1
1 1 0 0 0 0 0 0 0 0 0 5 0 0 5 0 0 0 0 5 0 5 0 5 0 5 5 5 0 0 0 0 0 0 0 0 0 0 0 0 5 0 0 5 0 0 0 0 5 0 5 0 5 0 5 5 5 0 0 0 0 0 0 0 0 0 0 0 0 5 0 0 5 0 0 0 0 5 0 5 0 5 0 5 5 5 0 0 0 0 0 0 0 0 0 0 0 0 1 1
1 1 0 0 0 0 0 0 0 0 0 5 0 0 5 0 0 0 0 5 0 5 0 5 0 5 5 5 0 0 0 0 0 0 0 0 0 0 0 0 5 0 0 5 0 0 0 0 5 0 5 0 5 0 5 5 5 0 0 0 0 0 0 0 0 0 0 0 0 5 0 0 5 0 0 0 0 5 0 5 0 5 0 5 5 5 0 0 0 0 0 0 0 0 0 0 0 0 1 1
1 1 0 0 0 0 0 0 0 0 0 5 0 0 5 0 0 0 0 5 0 5 0 5 0 5 5 5 0 0 0 0 0 0 0 0 0 0 0 0 5 0 0 5 0 0 0 0 5 0 5 0 5 0 5 5 5 0 0 0 0 0 0 0 0 0 0 0 0 5 0 0 5 0 0 0 0 5 0 5 0 5 0 5 5 5 0 0 0 0 0 0 0 0 0 0 0 0 1 1
1 1 0 0 0 0 0 0 0 0 0 5 0 0 5 0 0 0 0 5 0 5 0 5 0 5 5 5 0 0 0 0 0 0 0 0 0 0 0 0 5 0 0 5 0 0 0 0 5 0 5 0 5 0 5 5 5 0 0 0 0 0 0 0 0 0 0 0 0 5 0 0 5 0 0 0 0 5 0 5 0 5 0 5 5 5 0 0 0 0 0 0 0 0 0 0 0 0 1 1
1 1 0 0 0 0 0 0 0 0 0 5 0 0 5 0 0 0 0 5 0 5 0 5 0 5 5 5 0 0 0 0 0 0 0 0 0 0 0 0 5 0 0 5 0 0 0 0 5 0 5 0 5 0 5 5 5 0 0 0 0 0 0 0 0 0 0 0 0 5 0 0 5 0 0 0 0 5 0 5 0 5 0 5 5 5 0 0 0 0 0 0 0 0 0 0 0 0 1 1
1 1 0 0 0 0 0 0 0 0 0 5 0 0 5 0 0 0 0 5 0 5 0 5 0 5 5 5 0 0 0 0 0 0 0 0 0 0 0 0 5 0 0 5 0 0 0 0 5 0 5 0 5 0 5 5 5 0 0 0 0 0 0 0 0 0 0 0 0 5 0 0 5 0 0 0 0 5 0 5 0 5 0 5 5 5 0 0 0 0 0 0 0 0 0 0 0 0 1 1
1 1 0 0 0 0 0 0 0 0 0 5 0 0 5 0 0 0 0 5 0 5 0 5 0 5 5 5 0 0 0 0 0 0 0 0 0 0 0 0 5 0 0 5 0 0 0 0 5 0 5 0 5 0 5 5 5 0 0 0 0 0 0 0 0 0 0 0 0 5 0 0 5 0 0 0 0 5 0 5 0 5 0 5 5 5 0 0 0 0 0 0 0 0 0 0 0 0 1 1
1 1 0 0 0 0 0 0 0 0 0 5 0 0 5 0 0 0 0 5 0 5 0 5 0 5 5 5 0 0 0 0 0 0 0 0 0 0 0 0 5 0 0 5 0 0 0 0 5 0 5 0 5 0 5 5 5 0 0 0 0 0 0 0 0 0 0 0 0 5 0 0 5 0 0 0 0 5 0 5 0 5 0 5 5 5 0 0 0 0 0 0 0 0 0 0 0 0 1 1
1 1 0 0 0 0 0 0 0 0 0 5 0 0 5 0 0 0 0 5 0 5 0 5 0 5 5 5 0 0 0 0 0 0 0 0 0 0 0 0 5 0 0 5 0 0 0 0 5 0 5 0 5 0 5 5 5 0 0 0 0 0 0 0 0 0 0 0 0 5 0 0 5 0 0 0 0 5 0 5 0 5 0 5 5 5 0 0 0 0 0 0 0 0 0 0 0 0 1 1
1 1 0 0 0 0 0 0 0 0 0 5 0 0 5 0 0 0 0 5 0 5 0 5 0 5 5 5 0 0 0 0 0 0 0 0 0 0 0 0 5 0 0 5 0 0 0 0 5 0 5 0 5 0 5 5 5 0 0 0 0 0 0 0 0 0 0 0 0 5 0 0 5 0 0 0 0 5 0 5 0 5 0 5 5 5 0 0 0 0 0 0 0 0 0 0 0 0 1 1
1 1 0 0 0 0 0 0 0 0 0 5 0 0 5 0 0 0 0 5 0 5 0 5 0 5 5 5 0 0 0 0 0 0 0 0 0 0 0 0 5 0 0 5 0 0 0 0 5 0 5 0 5 0 5 5 5 0 0 0 0 0 0 0 0 0 0 0 0 5 0 0 5 0 0 0 0 5 0 5 0 5 0 5 5 5 0 0 0 0 0 0 0 0 0 0 0 0 1 1
1 1 0 0 0 0 0 0 0 0 0 5 0 0 5 0 0 0 0 5 0 5 0 5 0 5 5 5 0 0 0 0 0 0 0 0 0 0 0 0 5 0 0 5 0 0 0 0 5 0 5 0 5 0 5 5 5 0 0 0 0 0 0 0 0 0 0 0 0 5 0 0 5 0 0 0 0 5 0 5 0 5 0 5 5 5 0 0 0 0 0 0 0 0 0 0 0 0 1 1
1 1 0 0 0 0 0 0 0 0 0 5 0 0 5 0 0 0 0 5 0 5 0 5 0 5 5 5 0 0 0 0 0 0 0 0 0 0 0 0 5 0 0 5 0 0 0 0 5 0 5 0 5 0 5 5 5 0 0 0 0 0 0 0 0 0 0 0 0 5 0 0 5 0 0 0 0 5 0 5 0 5 0 5 5 5 0 0 0 0 0 0 0 0 0 0 0 0 1 1
1 1 0 0 0 0 0 0 0 0 0 5 0 0 5 0 0 0 0 5 0 5 0 5 0 5 5 5 0 0 0 0 0 0 0 0 0 0 0 0 5 0 0 5 0 0 0 0 5 0 5 0 5 0 5 5 5 0 0 0 0 0 0 0 0 0 0 0 0 5 0 0 5 0 0 0 0 5 0 5 0 5 0 5 5 5 0 0 0 0 0 0 0 0 0 0 0 0 1 1
1 1 0 0 0 0 0 0 0 0 0 5 0 0 5 0 0 0 0 5 0 5 0 5 0 5 5 5 0 0 0 0 0 0 0 0 0 0 0 0 5 0 0 5 0 0 0 0 5 0 5 0 5 0 5 5 5 0 0 0 0 0 0 0 0 0 0 0 0 5 0 0 5 0 0 0 0 5 0 5 0 5 0 5 5 5 0 0 0 0 0 0 0 0 0 0 0 0 1 1
1 1 0 0 0 0 0 0 0 0 0 5 0 0 5 0 0 0 0 5 0 5 0 5 0 5 5 5 0 0 0 0 0 0 0 0 0 0 0 0 5 0 0 5 0 0 0 0 5 0 5 0 5 0 5 5 5 0 0 0 0 0 0 0 0 0 0 0 0 5 0 0 5 0 0 0 0 5 0 5 0 5 0 5 5 5 0 0 0 0 0 0 0 0 0 0 0 0 1 1
1 1 0 0 0 0 0 0 0 0 0 5 0 0 5 0 0 0 0 5 0 5 0 5 0 5 5 5 0 0 0 0 0 0 0 0 0 0 0 0 5 0 0 5 0 0 0 0 5 0 5 0 5 0 5 5 5 0 0 0 0 0 0 0 0 0 0 0 0 5 0 0 5 0 0 0 0 5 0 5 0 5 0 5 5 5 0 0 0 0 0 0 0 0 0 0 0 0 1 1
1 1 0 0 0 0 0 0 0 0 0 5 0 0 5 0 0 0 0 5 0 5 0 5 0 5 5 5 0 0 0 0 0 0 0 0 0 0 0 0 5 0 0 5 0 0 0 0 5 0 5 0 5 0 5 5 5 0 0 0 0 0 0 0 0 0 0 0 0 5 0 0 5 0 0 0 0 5 0 5 0 5 0 5 5 5 0 0 0 0 0 0 0 0 0 0 0 0 1 1
1 1 0 0 0 0 0 0 0 0 0 5 0 0 5 0 0 0 0 5 0 5 0 5 0 5 5 5 0 0 0 0 0 0 0 0 0 0 0 0 5 0 0 5 0 0 0 0 5 0 5 0 5 0 5 5 5 0 0 0 0 0 0 0 0 0 0 0 0 5 0 0 5 0 0 0 0 5 0 5 0 5 0 5 5 5 0 0 0 0 0 0 0 0 0 0 0 0 1 1
1 1 0 0 0 0 0 0 0 0 0 5 0 0 5 0 0 0 0 5 0 5 0 5 0 5 5 5 0 0 0 0 0 0 0 0 0 0 0 0 5 0 0 5 0 0 0 0 5 0 5 0 5 0 5 5 5 0 0 0 0 0 0 0 0 0 0 0 0 5 0 0 5 0 0 0 0 5 0 5 0 5 0 5 5 5 0 0 0 0 0 0 0 0 0 0 0 0 1 1
1 1 0 0 0 0 0 0 0 0 0 5 0 0 5 0 0 0 0 5 0 5 0 5 0 5 5 5 0 0 0 0 0 0 0 0 0 0 0 0 5 0 0 5 0 0 0 0 5 0 5 0 5 0 5 5 5 0 0 0 0 0 0 0 0 0 0 0 0 5 0 0 5 0 0 0 0 5 0 5 0 5 0 5 5 5 0 0 0 0 0 0 0 0 0 0 0 0 1 1
1 1 0 0 0 0 0 0 0 0 0 5 0 0 5 0 0 0 0 5 0 5 0 5 0 5 5 5 0 0 0 0 0 0 0 0 0 0 0 0 5 0 0 5 0 0 0 0 5 0 5 0 5 0 5 5 5 0 0 0 0 0 0 0 0 0 0 0 0 5 0 0 5 0 0 0 0 5 0 5 0 5 0 5 5 5 0 0 0 0 0 0 0 0 0 0 0 0 1 1
1 1 0 0 0 0 0 0 0 0 0 5 0 0 5 0 0 0 0 5 0 5 0 5 0 5 5 5 0 0 0 0 0 0 0 0 0 0 0 0 5 0 0 5 0 0 0 0 5 0 5 0 5 0 5 5 5 0 0 0 0 0 0 0 0 0 0 0 0 5 0 0 5 0 0 0 0 5 0 5 0 5 0 5 5 5 0 0 0 0 0 0 0 0 0 0 0 0 1 1
1 1 0 0 0 0 0 0 0 0 0 5 0 0 5 0 0 0 0 5 0 5 0 5 0 5 5 5 0 0 0 0 0 0 0 0 0 0 0 0 5 0 0 5 0 0 0 0 5 0 5 0 5 0 5 5 5 0 0 0 0 0 0 0 0 0 0 0 0 5 0 0 5 0 0 0 0 5 0 5 0 5 0 5 5 5 0 0 0 0 0 0 0 0 0 0 0 0 1 1
1 1 0 0 0 0 0 0 0 0 0 5 0 0 5 0 0 0 0 5 0 5 0 5 0 5 5 5 0 0 0 0 0 0 0 0 0 0 0 0 5 0 0 5 0 0 0 0 5 0 5 0 5 0 5 5 5 0 0 0 0 0 0 0 0 0 0 0 0 5 0 0 5 0 0 0 0 5 0 5 0 5 0 5 5 5 0 0 0 0 0 0 0 0 0 0 0 0 1 1
1 1 0 0 0 0 0 0 0 0 0 5 0 0 5 0 0 0 0 5 0 5 0 5 0 5 5 5 0 0 0 0 0 0 0 0 0 0 0 0 5 0 0 5 0 0 0 0 5 0 5 0 5 0 5 5 5 0 0 0 0 0 0 0 0 0 0 0 0 5 0 0 5 0 0 0 0 5 0 5 0 5 0 5 5 5 0 0 0 0 0 0 0 0 0 0 0 0 1 1
1 1 0 0 0 0 0 0 0 0 0 5 0 0 5 0 0 0 0 5 0 5 0 5 0 5 5 5 0 0 0 0 0 0 0 0 0 0 0 0 5 0 0 5 0 0 0 0 5 0 5 0 5 0 5 5 5 0 0 0 0 0 0 0 0 0 0 0 0 5 0 0 5 0 0 0 0 5 0 5 0 5 0 5 5 5 0 0 0 0 0 0 0 0 0 0 0 0 1 1
1 1 0 0 0 0 0 0 0 0 0 5 0 0 5 0 0 0 0 5 0 5 0 5 0 5 5 5 0 0 0 0 0 0 0 0 0 0 0 0 5 0 0 5 0 0 0 0 5 0 5 0 5 0 5 5 5 0 0 0 0 0 0 0 0 0 0 0 0 5 0 0 5 0 0 0 0 5 0 5 0 5 0 5 5 5 0 0 0 0 0 0 0 0 0 0 0 0 1 1
1 1 0 0 0 0 0 0 0 0 0 5 0 0 5 0 0 0 0 5 0 5 0 5 0 5 5 5 0 0 0 0 0 0 0 0 0 0 0 0 5 0 0 5 0 0 0 0 5 0 5 0 5 0 5 5 5 0 0 0 0 0 0 0 0 0 0 0 0 5 0 0 5 0 0 0 0 5 0 5 0 5 0 5 5 5 0 0 0 0 0 0 0 0 0 0 0 0 1 1
1 1 0 0 0 0 0 0 0 0 0 5 0 0 5 0 0 0 0 5 0 5 0 5 0 5 5 5 0 0 0 0 0 0 0 0 0 0 0 0 5 0 0 5 0 0 0 0 5 0 5 0 5 0 5 5 5 0 0 0 0 0 0 0 0 0 0 0 0 5 0 0 5 0 0 0 0 5 0 5 0 5 0 5 5 5 0 0 0 0 0 0 0 0 0 0 0 0 1 1
1 1 0 0 0 0 0 0 0 0 0 5 0 0 5 0 0 0 0 5 0 5 0 5 0 5 5 5 0 0 0 0 0 0 0 0 0 0 0 0 5 0 0 5 0 0 0 0 5 0 5 0 5 0 5 5 5 0 0 0 0 0 0 0 0 0 0 0 0 5 0 0 5 0 0 0 0 5 0 5 0 5 0 5 5 5 0 0 0 0 0 0 0 0 0 0 0 0 1 1
1 1 0 0 0 0 0 0 0 0 0 5 0 0 5 0 0 0 0 5 0 5 0 5 0 5 5 5 0 0 0 0 0 0 0 0 0 0 0 0 5 0 0 5 0 0 0 0 5 0 5 0 5 0 5 5 5 0 0 0 0 0 0 0 0 0 0 0 0 5 0 0 5 0 0 0 0 5 0 5 0 5 0 5 5 5 0 0 0 0 0 0 0 0 0 0 0 0 1 1
1 1 0 0 0 0 0 0 0 0 0 5 0 0 5 0 0 0 0 5 0 5 0 5 0 5 5 5 0 0 0 0 0 0 0 0 0 0 0 0 5 0 0 5 0 0 0 0 5 0 5 0 5 0 5 5 5 0 0 0 0 0 0 0 0 0 0 0 0 5 0 0 5 0 0 0 0 5 0 5 0 5 0 5 5 5 0 0 0 0 0 0 0 0 0 0 0 0 1 1
1 1 0 0 0 0 0 0 0 0 0 5 0 0 5 0 0 0 0 5 0 5 0 5 0 5 5 5 0 0 0 0 0 0 0 0 0 0 0 0 5 0 0 5 0 0 0 0 5 0 5 0 5 0 5 5 5 0 0 0 0 0 0 0 0 0 0 0 0 5 0 0 5 0 0 0 0 5 0 5 0 5 0 5 5 5 0 0 0 0 0 0 0 0 0 0 0 0 1 1
1 1 0 0 0 0 0 0 0 0 0 5 0 0 5 0 0 0 0 5 0 5 0 5 0 5 5 5 0 0 0 0 0 0 0 0 0 0 0 0 5 0 0 5 0 0 0 0 5 0 5 0 5 0 5 5 5 0 0 0 0 0 0 0 0 0 0 0 0 5 0 0 5 0 0 0 0 5 0 5 0 5 0 5 5 5 0 0 0 0 0 0 0 0 0 0 0 0 1 1
1 1 0 0 0 0 0 0 0 0 0 5 0 0 5 0 0 0 0 5 0 5 0 5 0 5 5 5 0 0 0 0 0 0 0 0 0 0 0 0 5 0 0 5 0 0 0 0 5 0 5 0 5 0 5 5 5 0 0 0 0 0 0 0 0 0 0 0 0 5 0 0 5 0 0 0 0 5 0 5 0 5 0 5 5 5 0 0 0 0 0 0 0 0 0 0 0 0 1 1
1 1 0 0 0 0 0 0 0 0 0 5 0 0 5 0 0 0 0 5 0 5 0 5 0 5 5 5 0 0 0 0 0 0 0 0 0 0 0 0 5 0 0 5 0 0 0 0 5 0 5 0 5 0 5 5 5 0 0 0 0 0 0 0 0 0 0 0 0 5 0 0 5 0 0 0 0 5 0 5 0 5 0 5 5 5 0 0 0 0 0 0 0 0 0 0 0 0 1 1
1 1 0 0 0 0 0 0 0 0 0 5 0 0 5 0 0 0 0 5 0 5 0 5 0 5 5 5 0 0 0 0 0 0 0 0 0 0 0 0 5 0 0 5 0 0 0 0 5 0 5 0 5 0 5 5 5 0 0 0 0 0 0 0 0 0 0 0 0 5 0 0 5 0 0 0 0 5 0 5 0 5 0 5 5 5 0 0 0 0 0 0 0 0 0 0 0 0 1 11 1 0 0 0 0 0 0 0 0 0 5 0 0 5 0 0 0 0 5 0 5 0 5 0 5 5 5 0 0 0 0 0 0 0 0 0 0 0 0 5 0 0 5 0 0 0 0 5 0 5 0 5 0 5 5 5 0 0 0 0 0 0 0 0 0 0 0 0 5 0 0 5 0 0 0 0 5 0 5 0 5 0 5 5 5 0 0 0 0 0 0 0 0 0 0 0 0 1 1
1 1 0 0 0 0 0 0 0 0 0 5 0 0 5 0 0 0 0 5 0 5 0 5 0 5 5 5 0 0 0 0 0 0 0 0 0 0 0 0 5 0 0 5 0 0 0 0 5 0 5 0 5 0 5 5 5 0 0 0 0 0 0 0 0 0 0 0 0 5 0 0 5 0 0 0 0 5 0 5 0 5 0 5 5 5 0 0 0 0 0 0 0 0 0 0 0 0 1 1
1 1 0 0 0 0 0 0 0 0 0 5 0 0 5 0 0 0 0 5 0 5 0 5 0 5 5 5 0 0 0 0 0 0 0 0 0 0 0 0 5 0 0 5 0 0 0 0 5 0 5 0 5 0 5 5 5 0 0 0 0 0 0 0 0 0 0 0 0 5 0 0 5 0 0 0 0 5 0 5 0 5 0 5 5 5 0 0 0 0 0 0 0 0 0 0 0 0 1 1
1 1 0 0 0 0 0 0 0 0 0 5 0 0 5 0 0 0 0 5 0 5 0 5 0 5 5 5 0 0 0 0 0 0 0 0 0 0 0 0 5 0 0 5 0 0 0 0 5 0 5 0 5 0 5 5 5 0 0 0 0 0 0 0 0 0 0 0 0 5 0 0 5 0 0 0 0 5 0 5 0 5 0 5 5 5 0 0 0 0 0 0 0 0 0 0 0 0 1 1
1 1 0 0 0 0 0 0 0 0 0 5 0 0 5 0 0 0 0 5 0 5 0 5 0 5 5 5 0 0 0 0 0 0 0 0 0 0 0 0 5 0 0 5 0 0 0 0 5 0 5 0 5 0 5 5 5 0 0 0 0 0 0 0 0 0 0 0 0 5 0 0 5 0 0 0 0 5 0 5 0 5 0 5 5 5 0 0 0 0 0 0 0 0 0 0 0 0 1 1
1 1 0 0 0 0 0 0 0 0 0 5 0 0 5 0 0 0 0 5 0 5 0 5 0 5 5 5 0 0 0 0 0 0 0 0 0 0 0 0 5 0 0 5 0 0 0 0 5 0 5 0 5 0 5 5 5 0 0 0 0 0 0 0 0 0 0 0 0 5 0 0 5 0 0 0 0 5 0 5 0 5 0 5 5 5 0 0 0 0 0 0 0 0 0 0 0 0 1 1
1 1 0 0 0 0 0 0 0 0 0 5 0 0 5 0 0 0 0 5 0 5 0 5 0 5 5 5 0 0 0 0 0 0 0 0 0 0 0 0 5 0 0 5 0 0 0 0 5 0 5 0 5 0 5 5 5 0 0 0 0 0 0 0 0 0 0 0 0 5 0 0 5 0 0 0 0 5 0 5 0 5 0 5 5 5 0 0 0 0 0 0 0 0 0 0 0 0 1 1
1 1 0 0 0 0 0 0 0 0 0 5 0 0 5 0 0 0 0 5 0 5 0 5 0 5 5 5 0 0 0 0 0 0 0 0 0 0 0 0 5 0 0 5 0 0 0 0 5 0 5 0 5 0 5 5 5 0 0 0 0 0 0 0 0 0 0 0 0 5 0 0 5 0 0 0 0 5 0 5 0 5 0 5 5 5 0 0 0 0 0 0 0 0 0 0 0 0 1 1
1 1 0 0 0 0 0 0 0 0 0 5 0 0 5 0 0 0 0 5 0 5 0 5 0 5 5 5 0 0 0 0 0 0 0 0 0 0 0 0 5 0 0 5 0 0 0 0 5 0 5 0 5 0 5 5 5 0 0 0 0 0 0 0 0 0 0 0 0 5 0 0 5 0 0 0 0 5 0 5 0 5 0 5 5 5 0 0 0 0 0 0 0 0 0 0 0 0 1 1
1 1 0 0 0 0 0 0 0 0 0 5 0 0 5 0 0 0 0 5 0 5 0 5 0 5 5 5 0 0 0 0 0 0 0 0 0 0 0 0 5 0 0 5 0 0 0 0 5 0 5 0 5 0 5 5 5 0 0 0 0 0 0 0 0 0 0 0 0 5 0 0 5 0 0 0 0 5 0 5 0 5 0 5 5 5 0 0 0 0 0 0 0 0 0 0 0 0 1 1
1 1 0 0 0 0 0 0 0 0 0 5 0 0 5 0 0 0 0 5 0 5 0 5 0 5 5 5 0 0 0 0 0 0 0 0 0 0 0 0 5 0 0 5 0 0 0 0 5 0 5 0 5 0 5 5 5 0 0 0 0 0 0 0 0 0 0 0 0 5 0 0 5 0 0 0 0 5 0 5 0 5 0 5 5 5 0 0 0 0 0 0 0 0 0 0 0 0 1 1
1 1 0 0 0 0 0 0 0 0 0 5 0 0 5 0 0 0 0 5 0 5 0 5 0 5 5 5 0 0 0 0 0 0 0 0 0 0 0 0 5 0 0 5 0 0 0 0 5 0 5 0 5 0 5 5 5 0 0 0 0 0 0 0 0 0 0 0 0 5 0 0 5 0 0 0 0 5 0 5 0 5 0 5 5 5 0 0 0 0 0 0 0 0 0 0 0 0 1 1
1 1 0 0 0 0 0 0 0 0 0 5 0 0 5 0 0 0 0 5 0 5 0 5 0 5 5 5 0 0 0 0 0 0 0 0 0 0 0 0 5 0 0 5 0 0 0 0 5 0 5 0 5 0 5 5 5 0 0 0 0 0 0 0 0 0 0 0 0 5 0 0 5 0 0 0 0 5 0 5 0 5 0 5 5 5 0 0 0 0 0 0 0 0 0 0 0 0 1 1
1 1 0 0 0 0 0 0 0 0 0 5 0 0 5 0 0 0 0 5 0 5 0 5 0 5 5 5 0 0 0 0 0 0 0 0 0 0 0 0 5 0 0 5 0 0 0 0 5 0 5 0 5 0 5 5 5 0 0 0 0 0 0 0 0 0 0 0 0 5 0 0 5 0 0 0 0 5 0 5 0 5 0 5 5 5 0 0 0 0 0 0 0 0 0 0 0 0 1 1
1 1 0 0 0 0 0 0 0 0 0 5 0 0 5 0 0 0 0 5 0 5 0 5 0 5 5 5 0 0 0 0 0 0 0 0 0 0 0 0 5 0 0 5 0 0 0 0 5 0 5 0 5 0 5 5 5 0 0 0 0 0 0 0 0 0 0 0 0 5 0 0 5 0 0 0 0 5 0 5 0 5 0 5 5 5 0 0 0 0 0 0 0 0 0 0 0 0 1 1
1 1 0 0 0 0 0 0 0 0 0 5 0 0 5 0 0 0 0 5 0 5 0 5 0 5 5 5 0 0 0 0 0 0 0 0 0 0 0 0 5 0 0 5 0 0 0 0 5 0 5 0 5 0 5 5 5 0 0 0 0 0 0 0 0 0 0 0 0 5 0 0 5 0 0 0 0 5 0 5 0 5 0 5 5 5 0 0 0 0 0 0 0 0 0 0 0 0 1 1
1 1 0 0 0 0 0 0 0 0 0 5 0 0 5 0 0 0 0 5 0 5 0 5 0 5 5 5 0 0 0 0 0 0 0 0 0 0 0 0 5 0 0 5 0 0 0 0 5 0 5 0 5 0 5 5 5 0 0 0 0 0 0 0 0 0 0 0 0 5 0 0 5 0 0 0 0 5 0 5 0 5 0 5 5 5 0 0 0 0 0 0 0 0 0 0 0 0 1 1
1 1 0 0 0 0 0 0 0 0 0 5 0 0 5 0 0 0 0 5 0 5 0 5 0 5 5 5 0 0 0 0 0 0 0 0 0 0 0 0 5 0 0 5 0 0 0 0 5 0 5 0 5 0 5 5 5 0 0 0 0 0 0 0 0 0 0 0 0 5 0 0 5 0 0 0 0 5 0 5 0 5 0 5 5 5 0 0 0 0 0 0 0 0 0 0 0 0 1 1
1 1 0 0 0 0 0 0 0 0 0 5 0 0 5 0 0 0 0 5 0 5 0 5 0 5 5 5 0 0 0 0 0 0 0 0 0 0 0 0 5 0 0 5 0 0 0 0 5 0 5 0 5 0 5 5 5 0 0 0 0 0 0 0 0 0 0 0 0 5 0 0 5 0 0 0 0 5 0 5 0 5 0 5 5 5 0 0 0 0 0 0 0 0 0 0 0 0 1 1
1 1 0 0 0 0 0 0 0 0 0 5 0 0 5 0 0 0 0 5 0 5 0 5 0 5 5 5 0 0 0 0 0 0 0 0 0 0 0 0 5 0 0 5 0 0 0 0 5 0 5 0 5 0 5 5 5 0 0 0 0 0 0 0 0 0 0 0 0 5 0 0 5 0 0 0 0 5 0 5 0 5 0 5 5 5 0 0 0 0 0 0 0 0 0 0 0 0 1 1
1 1 0 0 0 0 0 0 0 0 0 5 0 0 5 0 0 0 0 5 0 5 0 5 0 5 5 5 0 0 0 0 0 0 0 0 0 0 0 0 5 0 0 5 0 0 0 0 5 0 5 0 5 0 5 5 5 0 0 0 0 0 0 0 0 0 0 0 0 5 0 0 5 0 0 0 0 5 0 5 0 5 0 5 5 5 0 0 0 0 0 0 0 0 0 0 0 0 1 1
1 1 0 0 0 0 0 0 0 0 0 5 0 0 5 0 0 0 0 5 0 5 0 5 0 5 5 5 0 0 0 0 0 0 0 0 0 0 0 0 5 0 0 5 0 0 0 0 5 0 5 0 5 0 5 5 5 0 0 0 0 0 0 0 0 0 0 0 0 5 0 0 5 0 0 0 0 5 0 5 0 5 0 5 5 5 0 0 0 0 0 0 0 0 0 0 0 0 1 1
1 1 0 0 0 0 0 0 0 0 0 5 0 0 5 0 0 0 0 5 0 5 0 5 0 5 5 5 0 0 0 0 0 0 0 0 0 0 0 0 5 0 0 5 0 0 0 0 5 0 5 0 5 0 5 5 5 0 0 0 0 0 0 0 0 0 0 0 0 5 0 0 5 0 0 0 0 5 0 5 0 5 0 5 5 5 0 0 0 0 0 0 0 0 0 0 0 0 1 1
1 1 0 0 0 0 0 0 0 0 0 5 0 0 5 0 0 0 0 5 0 5 0 5 0 5 5 5 0 0 0 0 0 0 0 0 0 0 0 0 5 0 0 5 0 0 0 0 5 0 5 0 5 0 5 5 5 0 0 0 0 0 0 0 0 0 0 0 0 5 0 0 5 0 0 0 0 5 0 5 0 5 0 5 5 5 0 0 0 0 0 0 0 0 0 0 0 0 1 1
1 1 0 0 0 0 0 0 0 0 0 5 0 0 5 0 0 0 0 5 0 5 0 5 0 5 5 5 0 0 0 0 0 0 0 0 0 0 0 0 5 0 0 5 0 0 0 0 5 0 5 0 5 0 5 5 5 0 0 0 0 0 0 0 0 0 0 0 0 5 0 0 5 0 0 0 0 5 0 5 0 5 0 5 5 5 0 0 0 0 0 0 0 0 0 0 0 0 1 1
1 1 0 0 0 0 0 0 0 0 0 5 0 0 5 0 0 0 0 5 0 5 0 5 0 5 5 5 0 0 0 0 0 0 0 0 0 0 0 0 5 0 0 5 0 0 0 0 5 0 5 0 5 0 5 5 5 0 0 0 0 0 0 0 0 0 0 0 0 5 0 0 5 0 0 0 0 5 0 5 0 5 0 5 5 5 0 0 0 0 0 0 0 0 0 0 0 0 1 1
1 1 0 0 0 0 0 0 0 0 0 5 0 0 5 0 0 0 0 5 0 5 0 5 0 5 5 5 0 0 0 0 0 0 0 0 0 0 0 0 5 0 0 5 0 0 0 0 5 0 5 0 5 0 5 5 5 0 0 0 0 0 0 0 0 0 0 0 0 5 0 0 5 0 0 0 0 5 0 5 0 5 0 5 5 5 0 0 0 0 0 0 0 0 0 0 0 0 1 1
1 1 0 0 0 0 0 0 0 0 0 5 0 0 5 0 0 0 0 5 0 5 0 5 0 5 5 5 0 0 0 0 0 0 0 0 0 0 0 0 5 0 0 5 0 0 0 0 5 0 5 0 5 0 5 5 5 0 0 0 0 0 0 0 0 0 0 0 0 5 0 0 5 0 0 0 0 5 0 5 0 5 0 5 5 5 0 0 0 0 0 0 0 0 0 0 0 0 1 1
1 1 0 0 0 0 0 0 0 0 0 5 0 0 5 0 0 0 0 5 0 5 0 5 0 5 5 5 0 0 0 0 0 0 0 0 0 0 0 0 5 0 0 5 0 0 0 0 5 0 5 0 5 0 5 5 5 0 0 0 0 0 0 0 0 0 0 0 0 5 0 0 5 0 0 0 0 5 0 5 0 5 0 5 5 5 0 0 0 0 0 0 0 0 0 0 0 0 1 1
1 1 0 0 0 0 0 0 0 0 0 5 0 0 5 0 0 0 0 5 0 5 0 5 0 5 5 5 0 0 0 0 0 0 0 0 0 0 0 0 5 0 0 5 0 0 0 0 5 0 5 0 5 0 5 5 5 0 0 0 0 0 0 0 0 0 0 0 0 5 0 0 5 0 0 0 0 5 0 5 0 5 0 5 5 5 0 0 0 0 0 0 0 0 0 0 0 0 1 1
1 1 0 0 0 0 0 0 0 0 0 5 0 0 5 0 0 0 0 5 0 5 0 5 0 5 5 5 0 0 0 0 0 0 0 0 0 0 0 0 5 0 0 5 0 0 0 0 5 0 5 0 5 0 5 5 5 0 0 0 0 0 0 0 0 0 0 0 0 5 0 0 5 0 0 0 0 5 0 5 0 5 0 5 5 5 0 0 0 0 0 0 0 0 0 0 0 0 1 1
1 1 0 0 0 0 0 0 0 0 0 5 0 0 5 0 0 0 0 5 0 5 0 5 0 5 5 5 0 0 0 0 0 0 0 0 0 0 0 0 5 0 0 5 0 0 0 0 5 0 5 0 5 0 5 5 5 0 0 0 0 0 0 0 0 0 0 0 0 5 0 0 5 0 0 0 0 5 0 5 0 5 0 5 5 5 0 0 0 0 0 0 0 0 0 0 0 0 1 1
1 1 0 0 0 0 0 0 0 0 0 5 0 0 5 0 0 0 0 5 0 5 0 5 0 5 5 5 0 0 0 0 0 0 0 0 0 0 0 0 5 0 0 5 0 0 0 0 5 0 5 0 5 0 5 5 5 0 0 0 0 0 0 0 0 0 0 0 0 5 0 0 5 0 0 0 0 5 0 5 0 5 0 5 5 5 0 0 0 0 0 0 0 0 0 0 0 0 1 1
1 1 0 0 0 0 0 0 0 0 0 5 0 0 5 0 0 0 0 5 0 5 0 5 0 5 5 5 0 0 0 0 0 0 0 0 0 0 0 0 5 0 0 5 0 0 0 0 5 0 5 0 5 0 5 5 5 0 0 0 0 0 0 0 0 0 0 0 0 5 0 0 5 0 0 0 0 5 0 5 0 5 0 5 5 5 0 0 0 0 0 0 0 0 0 0 0 0 1 1
1 1 0 0 0 0 0 0 0 0 0 5 0 0 5 0 0 0 0 5 0 5 0 5 0 5 5 5 0 0 0 0 0 0 0 0 0 0 0 0 5 0 0 5 0 0 0 0 5 0 5 0 5 0 5 5 5 0 0 0 0 0 0 0 0 0 0 0 0 5 0 0 5 0 0 0 0 5 0 5 0 5 0 5 5 5 0 0 0 0 0 0 0 0 0 0 0 0 1 1
1 1 0 0 0 0 0 0 0 0 0 5 0 0 5 0 0 0 0 5 0 5 0 5 0 5 5 5 0 0 0 0 0 0 0 0 0 0 0 0 5 0 0 5 0 0 0 0 5 0 5 0 5 0 5 5 5 0 0 0 0 0 0 0 0 0 0 0 0 5 0 0 5 0 0 0 0 5 0 5 0 5 0 5 5 5 0 0 0 0 0 0 0 0 0 0 0 0 1 1
1 1 0 0 0 0 0 0 0 0 0 5 0 0 5 0 0 0 0 5 0 5 0 5 0 5 5 5 0 0 0 0 0 0 0 0 0 0 0 0 5 0 0 5 0 0 0 0 5 0 5 0 5 0 5 5 5 0 0 0 0 0 0 0 0 0 0 0 0 5 0 0 5 0 0 0 0 5 0 5 0 5 0 5 5 5 0 0 0 0 0 0 0 0 0 0 0 0 1 1
1 1 0 0 0 0 0 0 0 0 0 5 0 0 5 0 0 0 0 5 0 5 0 5 0 5 5 5 0 0 0 0 0 0 0 0 0 0 0 0 5 0 0 5 0 0 0 0 5 0 5 0 5 0 5 5 5 0 0 0 0 0 0 0 0 0 0 0 0 5 0 0 5 0 0 0 0 5 0 5 0 5 0 5 5 5 0 0 0 0 0 0 0 0 0 0 0 0 1 1
1 1 0 0 0 0 0 0 0 0 0 5 0 0 5 0 0 0 0 5 0 5 0 5 0 5 5 5 0 0 0 0 0 0 0 0 0 0 0 0 5 0 0 5 0 0 0 0 5 0 5 0 5 0 5 5 5 0 0 0 0 0 0 0 0 0 0 0 0 5 0 0 5 0 0 0 0 5 0 5 0 5 0 5 5 5 0 0 0 0 0 0 0 0 0 0 0 0 1 1
1 1 0 0 0 0 0 0 0 0 0 5 0 0 5 0 0 0 0 5 0 5 0 5 0 5 5 5 0 0 0 0 0 0 0 0 0 0 0 0 5 0 0 5 0 0 0 0 5 0 5 0 5 0 5 5 5 0 0 0 0 0 0 0 0 0 0 0 0 5 0 0 5 0 0 0 0 5 0 5 0 5 0 5 5 5 0 0 0 0 0 0 0 0 0 0 0 0 1 1
1 1 0 0 0 0 0 0 0 0 0 5 0 0 5 0 0 0 0 5 0 5 0 5 0 5 5 5 0 0 0 0 0 0 0 0 0 0 0 0 5 0 0 5 0 0 0 0 5 0 5 0 5 0 5 5 5 0 0 0 0 0 0 0 0 0 0 0 0 5 0 0 5 0 0 0 0 5 0 5 0 5 0 5 5 5 0 0 0 0 0 0 0 0 0 0 0 0 1 1
1 1 0 0 0 0 0 0 0 0 0 5 0 0 5 0 0 0 0 5 0 5 0 5 0 5 5 5 0 0 0 0 0 0 0 0 0 0 0 0 5 0 0 5 0 0 0 0 5 0 5 0 5 0 5 5 5 0 0 0 0 0 0 0 0 0 0 0 0 5 0 0 5 0 0 0 0 5 0 5 0 5 0 5 5 5 0 0 0 0 0 0 0 0 0 0 0 0 1 1
1 1 0 0 0 0 0 0 0 0 0 5 0 0 5 0 0 0 0 5 0 5 0 5 0 5 5 5 0 0 0 0 0 0 0 0 0 0 0 0 5 0 0 5 0 0 0 0 5 0 5 0 5 0 5 5 5 0 0 0 0 0 0 0 0 0 0 0 0 5 0 0 5 0 0 0 0 5 0 5 0 5 0 5 5 5 0 0 0 0 0 0 0 0 0 0 0 0 1 1
1 1 0 0 0 0 0 0 0 0 0 5 0 0 5 0 0 0 0 5 0 5 0 5 0 5 5 5 0 0 0 0 0 0 0 0 0 0 0 0 5 0 0 5 0 0 0 0 5 0 5 0 5 0 5 5 5 0 0 0 0 0 0 0 0 0 0 0 0 5 0 0 5 0 0 0 0 5 0 5 0 5 0 5 5 5 0 0 0 0 0 0 0 0 0 0 0 0 1 1
1 1 0 0 0 0 0 0 0 0 0 5 0 0 5 0 0 0 0 5 0 5 0 5 0 5 5 5 0 0 0 0 0 0 0 0 0 0 0 0 5 0 0 5 0 0 0 0 5 0 5 0 5 0 5 5 5 0 0 0 0 0 0 0 0 0 0 0 0 5 0 0 5 0 0 0 0 5 0 5 0 5 0 5 5 5 0 0 0 0 0 0 0 0 0 0 0 0 1 1
1 1 0 0 0 0 0 0 0 0 0 5 0 0 5 0 0 0 0 5 0 5 0 5 0 5 5 5 0 0 0 0 0 0 0 0 0 0 0 0 5 0 0 5 0 0 0 0 5 0 5 0 5 0 5 5 5 0 0 0 0 0 0 0 0 0 0 0 0 5 0 0 5 0 0 0 0 5 0 5 0 5 0 5 5 5 0 0 0 0 0 0 0 0 0 0 0 0 1 1
1 1 0 0 0 0 0 0 0 0 0 5 0 0 5 0 0 0 0 5 0 5 0 5 0 5 5 5 0 0 0 0 0 0 0 0 0 0 0 0 5 0 0 5 0 0 0 0 5 0 5 0 5 0 5 5 5 0 0 0 0 0 0 0 0 0 0 0 0 5 0 0 5 0 0 0 0 5 0 5 0 5 0 5 5 5 0 0 0 0 0 0 0 0 0 0 0 0 1 1
1 1 0 0 0 0 0 0 0 0 0 5 0 0 5 0 0 0 0 5 0 5 0 5 0 5 5 5 0 0 0 0 0 0 0 0 0 0 0 0 5 0 0 5 0 0 0 0 5 0 5 0 5 0 5 5 5 0 0 0 0 0 0 0 0 0 0 0 0 5 0 0 5 0 0 0 0 5 0 5 0 5 0 5 5 5 0 0 0 0 0 0 0 0 0 0 0 0 1 1
1 1 0 0 0 0 0 0 0 0 0 5 0 0 5 0 0 0 0 5 0 5 0 5 0 5 5 5 0 0 0 0 0 0 0 0 0 0 0 0 5 0 0 5 0 0 0 0 5 0 5 0 5 0 5 5 5 0 0 0 0 0 0 0 0 0 0 0 0 5 0 0 5 0 0 0 0 5 0 5 0 5 0 5 5 5 0 0 0 0 0 0 0 0 0 0 0 0 1 1
1 1 0 0 0 0 0 0 0 0 0 5 0 0 5 0 0 0 0 5 0 5 0 5 0 5 5 5 0 0 0 0 0 0 0 0 0 0 0 0 5 0 0 5 0 0 0 0 5 0 5 0 5 0 5 5 5 0 0 0 0 0 0 0 0 0 0 0 0 5 0 0 5 0 0 0 0 5 0 5 0 5 0 5 5 5 0 0 0 0 0 0 0 0 0 0 0 0 1 1
1 1 0 0 0 0 0 0 0 0 0 5 0 0 5 0 0 0 0 5 0 5 0 5 0 5 5 5 0 0 0 0 0 0 0 0 0 0 0 0 5 0 0 5 0 0 0 0 5 0 5 0 5 0 5 5 5 0 0 0 0 0 0 0 0 0 0 0 0 5 0 0 5 0 0 0 0 5 0 5 0 5 0 5 5 5 0 0 0 0 0 0 0 0 0 0 0 0 1 1
1 1 0 0 0 0 0 0 0 0 0 5 0 0 5 0 0 0 0 5 0 5 0 5 0 5 5 5 0 0 0 0 0 0 0 0 0 0 0 0 5 0 0 5 0 0 0 0 5 0 5 0 5 0 5 5 5 0 0 0 0 0 0 0 0 0 0 0 0 5 0 0 5 0 0 0 0 5 0 5 0 5 0 5 5 5 0 0 0 0 0 0 0 0 0 0 0 0 1 1
1 1 0 0 0 0 0 0 0 0 0 5 0 0 5 0 0 0 0 5 0 5 0 5 0 5 5 5 0 0 0 0 0 0 0 0 0 0 0 0 5 0 0 5 0 0 0 0 5 0 5 0 5 0 5 5 5 0 0 0 0 0 0 0 0 0 0 0 0 5 0 0 5 0 0 0 0 5 0 5 0 5 0 5 5 5 0 0 0 0 0 0 0 0 0 0 0 0 1 1
1 1 1 1 1 1 1 1 1 1 1 1 1 1 1 1 1 1 1 1 1 1 1 1 1 1 1 1 1 1 1 1 1 1 1 1 1 1 1 1 1 1 1 1 1 1 1 1 1 1 1 1 1 1 1 1 1 1 1 1 1 1 1 1 1 1 1 1 1 1 1 1 1 1 1 1 1 1 1 1 1 1 1 1 1 1 1 1 1 1 1 1 1 1 1 1 1 1 1 1 
1 1 1 1 1 1 1 1 1 1 1 1 1 1 1 1 1 1 1 1 1 1 1 1 1 1 1 1 1 1 1 1 1 1 1 1 1 1 1 1 1 1 1 1 1 1 1 1 1 1 1 1 1 1 1 1 1 1 1 1 1 1 1 1 1 1 1 1 1 1 1 1 1 1 1 1 1 1 1 1 1 1 1 1 1 1 1 1 1 1 1 1 1 1 1 1 1 1 1 1 