2 2 2 2 2 2 2 2 2 2 2 2 2 2 2 2 2 2 2 2 2 2 2 2 2 2 2 2 2 2 2 2 2 2 2 2 2 2 2 2 2 2 2 2 2 2 2 2 2 2 2 2 2 2 2 2 2 2 2 2 2 2 2 2 2 2 2 2 2 2 2 2 2 2 2 2 2 2 2 2 2 2 2 2 2 2 2 2 2 2 2 2 2 2 2 2 2 2 2 2
2 2 2 2 2 2 2 2 2 2 2 2 2 2 2 2 2 2 2 2 2 2 2 2 2 2 2 2 2 2 2 2 2 2 2 2 2 2 2 2 2 2 2 2 2 2 2 2 2 2 2 2 2 2 2 2 2 2 2 2 2 2 2 2 2 2 2 2 2 2 2 2 2 2 2 2 2 2 2 2 2 2 2 2 2 2 2 2 2 2 2 2 2 2 2 2 2 2 2 2
3 3 3 3 3 3 3 3 3 3 3 3 3 3 3 3 3 3 3 3 3 3 3 3 3 3 3 3 3 3 3 3 3 3 3 3 3 3 3 3 3 3 3 3 3 3 3 3 3 3 3 3 3 3 3 3 3 3 3 3 3 3 3 3 3 3 3 3 3 3 3 3 3 3 3 3 3 3 3 3 3 3 3 3 3 3 3 3 3 3 3 3 3 3 3 3 3 3 3 3
3 3 3 3 3 3 3 3 3 3 3 3 3 3 3 3 3 3 3 3 3 3 3 3 3 3 3 3 3 3 3 3 3 3 3 3 3 3 3 3 3 3 3 3 3 3 3 3 3 3 3 3 3 3 3 3 3 3 3 3 3 3 3 3 3 3 3 3 3 3 3 3 3 3 3 3 3 3 3 3 3 3 3 3 3 3 3 3 3 3 3 3 3 3 3 3 3 3 3 3
3 3 3 3 3 3 3 3 3 3 3 3 3 3 3 3 3 3 3 3 3 3 3 3 3 3 3 3 3 3 3 3 3 3 3 3 3 3 3 3 3 3 3 3 3 3 3 3 3 3 3 3 3 3 3 3 3 3 3 3 3 3 3 3 3 3 3 3 3 3 3 3 3 3 3 3 3 3 3 3 3 3 3 3 3 3 3 3 3 3 3 3 3 3 3 3 3 3 3 3
3 3 3 3 3 3 3 3 3 3 3 3 3 3 3 3 3 3 3 3 3 3 3 3 3 3 3 3 3 3 3 3 3 3 3 3 3 3 3 3 3 3 3 3 3 3 3 3 3 3 3 3 3 3 3 3 3 3 3 3 3 3 3 3 3 3 3 3 3 3 3 3 3 3 3 3 3 3 3 3 3 3 3 3 3 3 3 3 3 3 3 3 3 3 3 3 3 3 3 3
1 1 9 9 9 9 9 9 9 9 9 5 9 9 5 9 9 9 9 5 9 5 9 5 9 5 5 5 9 9 9 9 9 9 9 9 9 9 9 9 5 9 9 5 9 9 9 9 5 9 5 9 5 9 5 5 5 9 9 9 9 9 9 9 9 9 9 9 9 5 9 9 5 9 9 9 9 5 9 5 9 5 9 5 5 5 9 9 9 9 9 9 9 9 9 9 9 9 1 1
1 1 9 9 9 9 9 9 9 9 9 5 9 9 5 9 9 9 9 5 9 5 9 5 9 5 5 5 9 9 9 9 9 9 9 9 9 9 9 9 5 9 9 5 9 9 9 9 5 9 5 9 5 9 5 5 5 9 9 9 9 9 9 9 9 9 9 9 9 5 9 9 5 9 9 9 9 5 9 5 9 5 9 5 5 5 9 9 9 9 9 9 9 9 9 9 9 9 1 1
1 1 9 9 9 9 9 9 9 9 9 5 9 9 5 9 9 9 9 5 9 5 9 5 9 5 5 5 9 9 9 9 9 9 9 9 9 9 9 9 5 9 9 5 9 9 9 9 5 9 5 9 5 9 5 5 5 9 9 9 9 9 9 9 9 9 9 9 9 5 9 9 5 9 9 9 9 5 9 5 9 5 9 5 5 5 9 9 9 9 9 9 9 9 9 9 9 9 1 1
1 1 9 9 9 9 9 9 9 9 9 5 9 9 5 9 9 9 9 5 9 5 9 5 9 5 5 5 9 9 9 9 9 9 9 9 9 9 9 9 5 9 9 5 9 9 9 9 5 9 5 9 5 9 5 5 5 9 9 9 9 9 9 9 9 9 9 9 9 5 9 9 5 9 9 9 9 5 9 5 9 5 9 5 5 5 9 9 9 9 9 9 9 9 9 9 9 9 1 1
1 1 9 9 9 9 9 9 9 9 9 5 9 9 5 9 9 9 9 5 9 5 9 5 9 5 5 5 9 9 9 9 9 9 9 9 9 9 9 9 5 9 9 5 9 9 9 9 5 9 5 9 5 9 5 5 5 9 9 9 9 9 9 9 9 9 9 9 9 5 9 9 5 9 9 9 9 5 9 5 9 5 9 5 5 5 9 9 9 9 9 9 9 9 9 9 9 9 1 1
1 1 9 9 9 9 9 9 9 9 9 5 9 9 5 9 9 9 9 5 9 5 9 5 9 5 5 5 9 9 9 9 9 9 9 9 9 9 9 9 5 9 9 5 9 9 9 9 5 9 5 9 5 9 5 5 5 9 9 9 9 9 9 9 9 9 9 9 9 5 9 9 5 9 9 9 9 5 9 5 9 5 9 5 5 5 9 9 9 9 9 9 9 9 9 9 9 9 1 1
1 1 9 9 9 9 9 9 9 9 9 5 9 9 5 9 9 9 9 5 9 5 9 5 9 5 5 5 9 9 9 9 9 9 9 9 9 9 9 9 5 9 9 5 9 9 9 9 5 9 5 9 5 9 5 5 5 9 9 9 9 9 9 9 9 9 9 9 9 5 9 9 5 9 9 9 9 5 9 5 9 5 9 5 5 5 9 9 9 9 9 9 9 9 9 9 9 9 1 1
1 1 9 9 9 9 9 9 9 9 9 5 9 9 5 9 9 9 9 5 9 5 9 5 9 5 5 5 9 9 9 9 9 9 9 9 9 9 9 9 5 9 9 5 9 9 9 9 5 9 5 9 5 9 5 5 5 9 9 9 9 9 9 9 9 9 9 9 9 5 9 9 5 9 9 9 9 5 9 5 9 5 9 5 5 5 9 9 9 9 9 9 9 9 9 9 9 9 1 1
1 1 9 9 9 9 9 9 9 9 9 5 9 9 5 9 9 9 9 5 9 5 9 5 9 5 5 5 9 9 9 9 9 9 9 9 9 9 9 9 5 9 9 5 9 9 9 9 5 9 5 9 5 9 5 5 5 9 9 9 9 9 9 9 9 9 9 9 9 5 9 9 5 9 9 9 9 5 9 5 9 5 9 5 5 5 9 9 9 9 9 9 9 9 9 9 9 9 1 1
1 1 9 9 9 9 9 9 9 9 9 5 9 9 5 9 9 9 9 5 9 5 9 5 9 5 5 5 9 9 9 9 9 9 9 9 9 9 9 9 5 9 9 5 9 9 9 9 5 9 5 9 5 9 5 5 5 9 9 9 9 9 9 9 9 9 9 9 9 5 9 9 5 9 9 9 9 5 9 5 9 5 9 5 5 5 9 9 9 9 9 9 9 9 9 9 9 9 1 1
1 1 9 9 9 9 9 9 9 9 9 5 9 9 5 9 9 9 9 5 9 5 9 5 9 5 5 5 9 9 9 9 9 9 9 9 9 9 9 9 5 9 9 5 9 9 9 9 5 9 5 9 5 9 5 5 5 9 9 9 9 9 9 9 9 9 9 9 9 5 9 9 5 9 9 9 9 5 9 5 9 5 9 5 5 5 9 9 9 9 9 9 9 9 9 9 9 9 1 1
1 1 9 9 9 9 9 9 9 9 9 5 9 9 5 9 9 9 9 5 9 5 9 5 9 5 5 5 9 9 9 9 9 9 9 9 9 9 9 9 5 9 9 5 9 9 9 9 5 9 5 9 5 9 5 5 5 9 9 9 9 9 9 9 9 9 9 9 9 5 9 9 5 9 9 9 9 5 9 5 9 5 9 5 5 5 9 9 9 9 9 9 9 9 9 9 9 9 1 1
1 1 9 9 9 9 9 9 9 9 9 5 9 9 5 9 9 9 9 5 9 5 9 5 9 5 5 5 9 9 9 9 9 9 9 9 9 9 9 9 5 9 9 5 9 9 9 9 5 9 5 9 5 9 5 5 5 9 9 9 9 9 9 9 9 9 9 9 9 5 9 9 5 9 9 9 9 5 9 5 9 5 9 5 5 5 9 9 9 9 9 9 9 9 9 9 9 9 1 1
1 1 9 9 9 9 9 9 9 9 9 5 9 9 5 9 9 9 9 5 9 5 9 5 9 5 5 5 9 9 9 9 9 9 9 9 9 9 9 9 5 9 9 5 9 9 9 9 5 9 5 9 5 9 5 5 5 9 9 9 9 9 9 9 9 9 9 9 9 5 9 9 5 9 9 9 9 5 9 5 9 5 9 5 5 5 9 9 9 9 9 9 9 9 9 9 9 9 1 1
1 1 9 9 9 9 9 9 9 9 9 5 9 9 5 9 9 9 9 5 9 5 9 5 9 5 5 5 9 9 9 9 9 9 9 9 9 9 9 9 5 9 9 5 9 9 9 9 5 9 5 9 5 9 5 5 5 9 9 9 9 9 9 9 9 9 9 9 9 5 9 9 5 9 9 9 9 5 9 5 9 5 9 5 5 5 9 9 9 9 9 9 9 9 9 9 9 9 1 1
1 1 9 9 9 9 9 9 9 9 9 5 9 9 5 9 9 9 9 5 9 5 9 5 9 5 5 5 9 9 9 9 9 9 9 9 9 9 9 9 5 9 9 5 9 9 9 9 5 9 5 9 5 9 5 5 5 9 9 9 9 9 9 9 9 9 9 9 9 5 9 9 5 9 9 9 9 5 9 5 9 5 9 5 5 5 9 9 9 9 9 9 9 9 9 9 9 9 1 1
1 1 9 9 9 9 9 9 9 9 9 5 9 9 5 9 9 9 9 5 9 5 9 5 9 5 5 5 9 9 9 9 9 9 9 9 9 9 9 9 5 9 9 5 9 9 9 9 5 9 5 9 5 9 5 5 5 9 9 9 9 9 9 9 9 9 9 9 9 5 9 9 5 9 9 9 9 5 9 5 9 5 9 5 5 5 9 9 9 9 9 9 9 9 9 9 9 9 1 1
1 1 9 9 9 9 9 9 9 9 9 5 9 9 5 9 9 9 9 5 9 5 9 5 9 5 5 5 9 9 9 9 9 9 9 9 9 9 9 9 5 9 9 5 9 9 9 9 5 9 5 9 5 9 5 5 5 9 9 9 9 9 9 9 9 9 9 9 9 5 9 9 5 9 9 9 9 5 9 5 9 5 9 5 5 5 9 9 9 9 9 9 9 9 9 9 9 9 1 1
1 1 9 9 9 9 9 9 9 9 9 5 9 9 5 9 9 9 9 5 9 5 9 5 9 5 5 5 9 9 9 9 9 9 9 9 9 9 9 9 5 9 9 5 9 9 9 9 5 9 5 9 5 9 5 5 5 9 9 9 9 9 9 9 9 9 9 9 9 5 9 9 5 9 9 9 9 5 9 5 9 5 9 5 5 5 9 9 9 9 9 9 9 9 9 9 9 9 1 1
1 1 9 9 9 9 9 9 9 9 9 5 9 9 5 9 9 9 9 5 9 5 9 5 9 5 5 5 9 9 9 9 9 9 9 9 9 9 9 9 5 9 9 5 9 9 9 9 5 9 5 9 5 9 5 5 5 9 9 9 9 9 9 9 9 9 9 9 9 5 9 9 5 9 9 9 9 5 9 5 9 5 9 5 5 5 9 9 9 9 9 9 9 9 9 9 9 9 1 1
1 1 9 9 9 9 9 9 9 9 9 5 9 9 5 9 9 9 9 5 9 5 9 5 9 5 5 5 9 9 9 9 9 9 9 9 9 9 9 9 5 9 9 5 9 9 9 9 5 9 5 9 5 9 5 5 5 9 9 9 9 9 9 9 9 9 9 9 9 5 9 9 5 9 9 9 9 5 9 5 9 5 9 5 5 5 9 9 9 9 9 9 9 9 9 9 9 9 1 1
1 1 9 9 9 9 9 9 9 9 9 5 9 9 5 9 9 9 9 5 9 5 9 5 9 5 5 5 9 9 9 9 9 9 9 9 9 9 9 9 5 9 9 5 9 9 9 9 5 9 5 9 5 9 5 5 5 9 9 9 9 9 9 9 9 9 9 9 9 5 9 9 5 9 9 9 9 5 9 5 9 5 9 5 5 5 9 9 9 9 9 9 9 9 9 9 9 9 1 1
1 1 9 9 9 9 9 9 9 9 9 5 9 9 5 9 9 9 9 5 9 5 9 5 9 5 5 5 9 9 9 9 9 9 9 9 9 9 9 9 5 9 9 5 9 9 9 9 5 9 5 9 5 9 5 5 5 9 9 9 9 9 9 9 9 9 9 9 9 5 9 9 5 9 9 9 9 5 9 5 9 5 9 5 5 5 9 9 9 9 9 9 9 9 9 9 9 9 1 1
1 1 9 9 9 9 9 9 9 9 9 5 9 9 5 9 9 9 9 5 9 5 9 5 9 5 5 5 9 9 9 9 9 9 9 9 9 9 9 9 5 9 9 5 9 9 9 9 5 9 5 9 5 9 5 5 5 9 9 9 9 9 9 9 9 9 9 9 9 5 9 9 5 9 9 9 9 5 9 5 9 5 9 5 5 5 9 9 9 9 9 9 9 9 9 9 9 9 1 1
1 1 9 9 9 9 9 9 9 9 9 5 9 9 5 9 9 9 9 5 9 5 9 5 9 5 5 5 9 9 9 9 9 9 9 9 9 9 9 9 5 9 9 5 9 9 9 9 5 9 5 9 5 9 5 5 5 9 9 9 9 9 9 9 9 9 9 9 9 5 9 9 5 9 9 9 9 5 9 5 9 5 9 5 5 5 9 9 9 9 9 9 9 9 9 9 9 9 1 1
1 1 9 9 9 9 9 9 9 9 9 5 9 9 5 9 9 9 9 5 9 5 9 5 9 5 5 5 9 9 9 9 9 9 9 9 9 9 9 9 5 9 9 5 9 9 9 9 5 9 5 9 5 9 5 5 5 9 9 9 9 9 9 9 9 9 9 9 9 5 9 9 5 9 9 9 9 5 9 5 9 5 9 5 5 5 9 9 9 9 9 9 9 9 9 9 9 9 1 1
1 1 9 9 9 9 9 9 9 9 9 5 9 9 5 9 9 9 9 5 9 5 9 5 9 5 5 5 9 9 9 9 9 9 9 9 9 9 9 9 5 9 9 5 9 9 9 9 5 9 5 9 5 9 5 5 5 9 9 9 9 9 9 9 9 9 9 9 9 5 9 9 5 9 9 9 9 5 9 5 9 5 9 5 5 5 9 9 9 9 9 9 9 9 9 9 9 9 1 1
1 1 9 9 9 9 9 9 9 9 9 5 9 9 5 9 9 9 9 5 9 5 9 5 9 5 5 5 9 9 9 9 9 9 9 9 9 9 9 9 5 9 9 5 9 9 9 9 5 9 5 9 5 9 5 5 5 9 9 9 9 9 9 9 9 9 9 9 9 5 9 9 5 9 9 9 9 5 9 5 9 5 9 5 5 5 9 9 9 9 9 9 9 9 9 9 9 9 1 1
1 1 9 9 9 9 9 9 9 9 9 5 9 9 5 9 9 9 9 5 9 5 9 5 9 5 5 5 9 9 9 9 9 9 9 9 9 9 9 9 5 9 9 5 9 9 9 9 5 9 5 9 5 9 5 5 5 9 9 9 9 9 9 9 9 9 9 9 9 5 9 9 5 9 9 9 9 5 9 5 9 5 9 5 5 5 9 9 9 9 9 9 9 9 9 9 9 9 1 1
1 1 9 9 9 9 9 9 9 9 9 5 9 9 5 9 9 9 9 5 9 5 9 5 9 5 5 5 9 9 9 9 9 9 9 9 9 9 9 9 5 9 9 5 9 9 9 9 5 9 5 9 5 9 5 5 5 9 9 9 9 9 9 9 9 9 9 9 9 5 9 9 5 9 9 9 9 5 9 5 9 5 9 5 5 5 9 9 9 9 9 9 9 9 9 9 9 9 1 1
1 1 9 9 9 9 9 9 9 9 9 5 9 9 5 9 9 9 9 5 9 5 9 5 9 5 5 5 9 9 9 9 9 9 9 9 9 9 9 9 5 9 9 5 9 9 9 9 5 9 5 9 5 9 5 5 5 9 9 9 9 9 9 9 9 9 9 9 9 5 9 9 5 9 9 9 9 5 9 5 9 5 9 5 5 5 9 9 9 9 9 9 9 9 9 9 9 9 1 1
1 1 9 9 9 9 9 9 9 9 9 5 9 9 5 9 9 9 9 5 9 5 9 5 9 5 5 5 9 9 9 9 9 9 9 9 9 9 9 9 5 9 9 5 9 9 9 9 5 9 5 9 5 9 5 5 5 9 9 9 9 9 9 9 9 9 9 9 9 5 9 9 5 9 9 9 9 5 9 5 9 5 9 5 5 5 9 9 9 9 9 9 9 9 9 9 9 9 1 1
1 1 9 9 9 9 9 9 9 9 9 5 9 9 5 9 9 9 9 5 9 5 9 5 9 5 5 5 9 9 9 9 9 9 9 9 9 9 9 9 5 9 9 5 9 9 9 9 5 9 5 9 5 9 5 5 5 9 9 9 9 9 9 9 9 9 9 9 9 5 9 9 5 9 9 9 9 5 9 5 9 5 9 5 5 5 9 9 9 9 9 9 9 9 9 9 9 9 1 1
1 1 9 9 9 9 9 9 9 9 9 5 9 9 5 9 9 9 9 5 9 5 9 5 9 5 5 5 9 9 9 9 9 9 9 9 9 9 9 9 5 9 9 5 9 9 9 9 5 9 5 9 5 9 5 5 5 9 9 9 9 9 9 9 9 9 9 9 9 5 9 9 5 9 9 9 9 5 9 5 9 5 9 5 5 5 9 9 9 9 9 9 9 9 9 9 9 9 1 1
1 1 9 9 9 9 9 9 9 9 9 5 9 9 5 9 9 9 9 5 9 5 9 5 9 5 5 5 9 9 9 9 9 9 9 9 9 9 9 9 5 9 9 5 9 9 9 9 5 9 5 9 5 9 5 5 5 9 9 9 9 9 9 9 9 9 9 9 9 5 9 9 5 9 9 9 9 5 9 5 9 5 9 5 5 5 9 9 9 9 9 9 9 9 9 9 9 9 1 1
1 1 9 9 9 9 9 9 9 9 9 5 9 9 5 9 9 9 9 5 9 5 9 5 9 5 5 5 9 9 9 9 9 9 9 9 9 9 9 9 5 9 9 5 9 9 9 9 5 9 5 9 5 9 5 5 5 9 9 9 9 9 9 9 9 9 9 9 9 5 9 9 5 9 9 9 9 5 9 5 9 5 9 5 5 5 9 9 9 9 9 9 9 9 9 9 9 9 1 1
1 1 9 9 9 9 9 9 9 9 9 5 9 9 5 9 9 9 9 5 9 5 9 5 9 5 5 5 9 9 9 9 9 9 9 9 9 9 9 9 5 9 9 5 9 9 9 9 5 9 5 9 5 9 5 5 5 9 9 9 9 9 9 9 9 9 9 9 9 5 9 9 5 9 9 9 9 5 9 5 9 5 9 5 5 5 9 9 9 9 9 9 9 9 9 9 9 9 1 1
1 1 9 9 9 9 9 9 9 9 9 5 9 9 5 9 9 9 9 5 9 5 9 5 9 5 5 5 9 9 9 9 9 9 9 9 9 9 9 9 5 9 9 5 9 9 9 9 5 9 5 9 5 9 5 5 5 9 9 9 9 9 9 9 9 9 9 9 9 5 9 9 5 9 9 9 9 5 9 5 9 5 9 5 5 5 9 9 9 9 9 9 9 9 9 9 9 9 1 1
1 1 9 9 9 9 9 9 9 9 9 5 9 9 5 9 9 9 9 5 9 5 9 5 9 5 5 5 9 9 9 9 9 9 9 9 9 9 9 9 5 9 9 5 9 9 9 9 5 9 5 9 5 9 5 5 5 9 9 9 9 9 9 9 9 9 9 9 9 5 9 9 5 9 9 9 9 5 9 5 9 5 9 5 5 5 9 9 9 9 9 9 9 9 9 9 9 9 1 1
1 1 9 9 9 9 9 9 9 9 9 5 9 9 5 9 9 9 9 5 9 5 9 5 9 5 5 5 9 9 9 9 9 9 9 9 9 9 9 9 5 9 9 5 9 9 9 9 5 9 5 9 5 9 5 5 5 9 9 9 9 9 9 9 9 9 9 9 9 5 9 9 5 9 9 9 9 5 9 5 9 5 9 5 5 5 9 9 9 9 9 9 9 9 9 9 9 9 1 11 1 9 9 9 9 9 9 9 9 9 5 9 9 5 9 9 9 9 5 9 5 9 5 9 5 5 5 9 9 9 9 9 9 9 9 9 9 9 9 5 9 9 5 9 9 9 9 5 9 5 9 5 9 5 5 5 9 9 9 9 9 9 9 9 9 9 9 9 5 9 9 5 9 9 9 9 5 9 5 9 5 9 5 5 5 9 9 9 9 9 9 9 9 9 9 9 9 1 1
1 1 9 9 9 9 9 9 9 9 9 5 9 9 5 9 9 9 9 5 9 5 9 5 9 5 5 5 9 9 9 9 9 9 9 9 9 9 9 9 5 9 9 5 9 9 9 9 5 9 5 9 5 9 5 5 5 9 9 9 9 9 9 9 9 9 9 9 9 5 9 9 5 9 9 9 9 5 9 5 9 5 9 5 5 5 9 9 9 9 9 9 9 9 9 9 9 9 1 1
1 1 9 9 9 9 9 9 9 9 9 5 9 9 5 9 9 9 9 5 9 5 9 5 9 5 5 5 9 9 9 9 9 9 9 9 9 9 9 9 5 9 9 5 9 9 9 9 5 9 5 9 5 9 5 5 5 9 9 9 9 9 9 9 9 9 9 9 9 5 9 9 5 9 9 9 9 5 9 5 9 5 9 5 5 5 9 9 9 9 9 9 9 9 9 9 9 9 1 1
1 1 9 9 9 9 9 9 9 9 9 5 9 9 5 9 9 9 9 5 9 5 9 5 9 5 5 5 9 9 9 9 9 9 9 9 9 9 9 9 5 9 9 5 9 9 9 9 5 9 5 9 5 9 5 5 5 9 9 9 9 9 9 9 9 9 9 9 9 5 9 9 5 9 9 9 9 5 9 5 9 5 9 5 5 5 9 9 9 9 9 9 9 9 9 9 9 9 1 1
1 1 9 9 9 9 9 9 9 9 9 5 9 9 5 9 9 9 9 5 9 5 9 5 9 5 5 5 9 9 9 9 9 9 9 9 9 9 9 9 5 9 9 5 9 9 9 9 5 9 5 9 5 9 5 5 5 9 9 9 9 9 9 9 9 9 9 9 9 5 9 9 5 9 9 9 9 5 9 5 9 5 9 5 5 5 9 9 9 9 9 9 9 9 9 9 9 9 1 1
1 1 9 9 9 9 9 9 9 9 9 5 9 9 5 9 9 9 9 5 9 5 9 5 9 5 5 5 9 9 9 9 9 9 9 9 9 9 9 9 5 9 9 5 9 9 9 9 5 9 5 9 5 9 5 5 5 9 9 9 9 9 9 9 9 9 9 9 9 5 9 9 5 9 9 9 9 5 9 5 9 5 9 5 5 5 9 9 9 9 9 9 9 9 9 9 9 9 1 1
1 1 9 9 9 9 9 9 9 9 9 5 9 9 5 9 9 9 9 5 9 5 9 5 9 5 5 5 9 9 9 9 9 9 9 9 9 9 9 9 5 9 9 5 9 9 9 9 5 9 5 9 5 9 5 5 5 9 9 9 9 9 9 9 9 9 9 9 9 5 9 9 5 9 9 9 9 5 9 5 9 5 9 5 5 5 9 9 9 9 9 9 9 9 9 9 9 9 1 1
1 1 9 9 9 9 9 9 9 9 9 5 9 9 5 9 9 9 9 5 9 5 9 5 9 5 5 5 9 9 9 9 9 9 9 9 9 9 9 9 5 9 9 5 9 9 9 9 5 9 5 9 5 9 5 5 5 9 9 9 9 9 9 9 9 9 9 9 9 5 9 9 5 9 9 9 9 5 9 5 9 5 9 5 5 5 9 9 9 9 9 9 9 9 9 9 9 9 1 1
1 1 9 9 9 9 9 9 9 9 9 5 9 9 5 9 9 9 9 5 9 5 9 5 9 5 5 5 9 9 9 9 9 9 9 9 9 9 9 9 5 9 9 5 9 9 9 9 5 9 5 9 5 9 5 5 5 9 9 9 9 9 9 9 9 9 9 9 9 5 9 9 5 9 9 9 9 5 9 5 9 5 9 5 5 5 9 9 9 9 9 9 9 9 9 9 9 9 1 1
1 1 9 9 9 9 9 9 9 9 9 5 9 9 5 9 9 9 9 5 9 5 9 5 9 5 5 5 9 9 9 9 9 9 9 9 9 9 9 9 5 9 9 5 9 9 9 9 5 9 5 9 5 9 5 5 5 9 9 9 9 9 9 9 9 9 9 9 9 5 9 9 5 9 9 9 9 5 9 5 9 5 9 5 5 5 9 9 9 9 9 9 9 9 9 9 9 9 1 1
1 1 9 9 9 9 9 9 9 9 9 5 9 9 5 9 9 9 9 5 9 5 9 5 9 5 5 5 9 9 9 9 9 9 9 9 9 9 9 9 5 9 9 5 9 9 9 9 5 9 5 9 5 9 5 5 5 9 9 9 9 9 9 9 9 9 9 9 9 5 9 9 5 9 9 9 9 5 9 5 9 5 9 5 5 5 9 9 9 9 9 9 9 9 9 9 9 9 1 1
1 1 9 9 9 9 9 9 9 9 9 5 9 9 5 9 9 9 9 5 9 5 9 5 9 5 5 5 9 9 9 9 9 9 9 9 9 9 9 9 5 9 9 5 9 9 9 9 5 9 5 9 5 9 5 5 5 9 9 9 9 9 9 9 9 9 9 9 9 5 9 9 5 9 9 9 9 5 9 5 9 5 9 5 5 5 9 9 9 9 9 9 9 9 9 9 9 9 1 1
1 1 9 9 9 9 9 9 9 9 9 5 9 9 5 9 9 9 9 5 9 5 9 5 9 5 5 5 9 9 9 9 9 9 9 9 9 9 9 9 5 9 9 5 9 9 9 9 5 9 5 9 5 9 5 5 5 9 9 9 9 9 9 9 9 9 9 9 9 5 9 9 5 9 9 9 9 5 9 5 9 5 9 5 5 5 9 9 9 9 9 9 9 9 9 9 9 9 1 1
1 1 9 9 9 9 9 9 9 9 9 5 9 9 5 9 9 9 9 5 9 5 9 5 9 5 5 5 9 9 9 9 9 9 9 9 9 9 9 9 5 9 9 5 9 9 9 9 5 9 5 9 5 9 5 5 5 9 9 9 9 9 9 9 9 9 9 9 9 5 9 9 5 9 9 9 9 5 9 5 9 5 9 5 5 5 9 9 9 9 9 9 9 9 9 9 9 9 1 1
1 1 9 9 9 9 9 9 9 9 9 5 9 9 5 9 9 9 9 5 9 5 9 5 9 5 5 5 9 9 9 9 9 9 9 9 9 9 9 9 5 9 9 5 9 9 9 9 5 9 5 9 5 9 5 5 5 9 9 9 9 9 9 9 9 9 9 9 9 5 9 9 5 9 9 9 9 5 9 5 9 5 9 5 5 5 9 9 9 9 9 9 9 9 9 9 9 9 1 1
1 1 9 9 9 9 9 9 9 9 9 5 9 9 5 9 9 9 9 5 9 5 9 5 9 5 5 5 9 9 9 9 9 9 9 9 9 9 9 9 5 9 9 5 9 9 9 9 5 9 5 9 5 9 5 5 5 9 9 9 9 9 9 9 9 9 9 9 9 5 9 9 5 9 9 9 9 5 9 5 9 5 9 5 5 5 9 9 9 9 9 9 9 9 9 9 9 9 1 1
1 1 9 9 9 9 9 9 9 9 9 5 9 9 5 9 9 9 9 5 9 5 9 5 9 5 5 5 9 9 9 9 9 9 9 9 9 9 9 9 5 9 9 5 9 9 9 9 5 9 5 9 5 9 5 5 5 9 9 9 9 9 9 9 9 9 9 9 9 5 9 9 5 9 9 9 9 5 9 5 9 5 9 5 5 5 9 9 9 9 9 9 9 9 9 9 9 9 1 1
1 1 9 9 9 9 9 9 9 9 9 5 9 9 5 9 9 9 9 5 9 5 9 5 9 5 5 5 9 9 9 9 9 9 9 9 9 9 9 9 5 9 9 5 9 9 9 9 5 9 5 9 5 9 5 5 5 9 9 9 9 9 9 9 9 9 9 9 9 5 9 9 5 9 9 9 9 5 9 5 9 5 9 5 5 5 9 9 9 9 9 9 9 9 9 9 9 9 1 1
1 1 9 9 9 9 9 9 9 9 9 5 9 9 5 9 9 9 9 5 9 5 9 5 9 5 5 5 9 9 9 9 9 9 9 9 9 9 9 9 5 9 9 5 9 9 9 9 5 9 5 9 5 9 5 5 5 9 9 9 9 9 9 9 9 9 9 9 9 5 9 9 5 9 9 9 9 5 9 5 9 5 9 5 5 5 9 9 9 9 9 9 9 9 9 9 9 9 1 1
1 1 9 9 9 9 9 9 9 9 9 5 9 9 5 9 9 9 9 5 9 5 9 5 9 5 5 5 9 9 9 9 9 9 9 9 9 9 9 9 5 9 9 5 9 9 9 9 5 9 5 9 5 9 5 5 5 9 9 9 9 9 9 9 9 9 9 9 9 5 9 9 5 9 9 9 9 5 9 5 9 5 9 5 5 5 9 9 9 9 9 9 9 9 9 9 9 9 1 1
1 1 9 9 9 9 9 9 9 9 9 5 9 9 5 9 9 9 9 5 9 5 9 5 9 5 5 5 9 9 9 9 9 9 9 9 9 9 9 9 5 9 9 5 9 9 9 9 5 9 5 9 5 9 5 5 5 9 9 9 9 9 9 9 9 9 9 9 9 5 9 9 5 9 9 9 9 5 9 5 9 5 9 5 5 5 9 9 9 9 9 9 9 9 9 9 9 9 1 1
1 1 9 9 9 9 9 9 9 9 9 5 9 9 5 9 9 9 9 5 9 5 9 5 9 5 5 5 9 9 9 9 9 9 9 9 9 9 9 9 5 9 9 5 9 9 9 9 5 9 5 9 5 9 5 5 5 9 9 9 9 9 9 9 9 9 9 9 9 5 9 9 5 9 9 9 9 5 9 5 9 5 9 5 5 5 9 9 9 9 9 9 9 9 9 9 9 9 1 1
1 1 9 9 9 9 9 9 9 9 9 5 9 9 5 9 9 9 9 5 9 5 9 5 9 5 5 5 9 9 9 9 9 9 9 9 9 9 9 9 5 9 9 5 9 9 9 9 5 9 5 9 5 9 5 5 5 9 9 9 9 9 9 9 9 9 9 9 9 5 9 9 5 9 9 9 9 5 9 5 9 5 9 5 5 5 9 9 9 9 9 9 9 9 9 9 9 9 1 1
1 1 9 9 9 9 9 9 9 9 9 5 9 9 5 9 9 9 9 5 9 5 9 5 9 5 5 5 9 9 9 9 9 9 9 9 9 9 9 9 5 9 9 5 9 9 9 9 5 9 5 9 5 9 5 5 5 9 9 9 9 9 9 9 9 9 9 9 9 5 9 9 5 9 9 9 9 5 9 5 9 5 9 5 5 5 9 9 9 9 9 9 9 9 9 9 9 9 1 1
1 1 9 9 9 9 9 9 9 9 9 5 9 9 5 9 9 9 9 5 9 5 9 5 9 5 5 5 9 9 9 9 9 9 9 9 9 9 9 9 5 9 9 5 9 9 9 9 5 9 5 9 5 9 5 5 5 9 9 9 9 9 9 9 9 9 9 9 9 5 9 9 5 9 9 9 9 5 9 5 9 5 9 5 5 5 9 9 9 9 9 9 9 9 9 9 9 9 1 1
1 1 9 9 9 9 9 9 9 9 9 5 9 9 5 9 9 9 9 5 9 5 9 5 9 5 5 5 9 9 9 9 9 9 9 9 9 9 9 9 5 9 9 5 9 9 9 9 5 9 5 9 5 9 5 5 5 9 9 9 9 9 9 9 9 9 9 9 9 5 9 9 5 9 9 9 9 5 9 5 9 5 9 5 5 5 9 9 9 9 9 9 9 9 9 9 9 9 1 1
1 1 9 9 9 9 9 9 9 9 9 5 9 9 5 9 9 9 9 5 9 5 9 5 9 5 5 5 9 9 9 9 9 9 9 9 9 9 9 9 5 9 9 5 9 9 9 9 5 9 5 9 5 9 5 5 5 9 9 9 9 9 9 9 9 9 9 9 9 5 9 9 5 9 9 9 9 5 9 5 9 5 9 5 5 5 9 9 9 9 9 9 9 9 9 9 9 9 1 1
1 1 9 9 9 9 9 9 9 9 9 5 9 9 5 9 9 9 9 5 9 5 9 5 9 5 5 5 9 9 9 9 9 9 9 9 9 9 9 9 5 9 9 5 9 9 9 9 5 9 5 9 5 9 5 5 5 9 9 9 9 9 9 9 9 9 9 9 9 5 9 9 5 9 9 9 9 5 9 5 9 5 9 5 5 5 9 9 9 9 9 9 9 9 9 9 9 9 1 1
1 1 9 9 9 9 9 9 9 9 9 5 9 9 5 9 9 9 9 5 9 5 9 5 9 5 5 5 9 9 9 9 9 9 9 9 9 9 9 9 5 9 9 5 9 9 9 9 5 9 5 9 5 9 5 5 5 9 9 9 9 9 9 9 9 9 9 9 9 5 9 9 5 9 9 9 9 5 9 5 9 5 9 5 5 5 9 9 9 9 9 9 9 9 9 9 9 9 1 1
1 1 9 9 9 9 9 9 9 9 9 5 9 9 5 9 9 9 9 5 9 5 9 5 9 5 5 5 9 9 9 9 9 9 9 9 9 9 9 9 5 9 9 5 9 9 9 9 5 9 5 9 5 9 5 5 5 9 9 9 9 9 9 9 9 9 9 9 9 5 9 9 5 9 9 9 9 5 9 5 9 5 9 5 5 5 9 9 9 9 9 9 9 9 9 9 9 9 1 1
1 1 9 9 9 9 9 9 9 9 9 5 9 9 5 9 9 9 9 5 9 5 9 5 9 5 5 5 9 9 9 9 9 9 9 9 9 9 9 9 5 9 9 5 9 9 9 9 5 9 5 9 5 9 5 5 5 9 9 9 9 9 9 9 9 9 9 9 9 5 9 9 5 9 9 9 9 5 9 5 9 5 9 5 5 5 9 9 9 9 9 9 9 9 9 9 9 9 1 1
1 1 9 9 9 9 9 9 9 9 9 5 9 9 5 9 9 9 9 5 9 5 9 5 9 5 5 5 9 9 9 9 9 9 9 9 9 9 9 9 5 9 9 5 9 9 9 9 5 9 5 9 5 9 5 5 5 9 9 9 9 9 9 9 9 9 9 9 9 5 9 9 5 9 9 9 9 5 9 5 9 5 9 5 5 5 9 9 9 9 9 9 9 9 9 9 9 9 1 1
1 1 9 9 9 9 9 9 9 9 9 5 9 9 5 9 9 9 9 5 9 5 9 5 9 5 5 5 9 9 9 9 9 9 9 9 9 9 9 9 5 9 9 5 9 9 9 9 5 9 5 9 5 9 5 5 5 9 9 9 9 9 9 9 9 9 9 9 9 5 9 9 5 9 9 9 9 5 9 5 9 5 9 5 5 5 9 9 9 9 9 9 9 9 9 9 9 9 1 1
1 1 9 9 9 9 9 9 9 9 9 5 9 9 5 9 9 9 9 5 9 5 9 5 9 5 5 5 9 9 9 9 9 9 9 9 9 9 9 9 5 9 9 5 9 9 9 9 5 9 5 9 5 9 5 5 5 9 9 9 9 9 9 9 9 9 9 9 9 5 9 9 5 9 9 9 9 5 9 5 9 5 9 5 5 5 9 9 9 9 9 9 9 9 9 9 9 9 1 1
1 1 9 9 9 9 9 9 9 9 9 5 9 9 5 9 9 9 9 5 9 5 9 5 9 5 5 5 9 9 9 9 9 9 9 9 9 9 9 9 5 9 9 5 9 9 9 9 5 9 5 9 5 9 5 5 5 9 9 9 9 9 9 9 9 9 9 9 9 5 9 9 5 9 9 9 9 5 9 5 9 5 9 5 5 5 9 9 9 9 9 9 9 9 9 9 9 9 1 1
1 1 9 9 9 9 9 9 9 9 9 5 9 9 5 9 9 9 9 5 9 5 9 5 9 5 5 5 9 9 9 9 9 9 9 9 9 9 9 9 5 9 9 5 9 9 9 9 5 9 5 9 5 9 5 5 5 9 9 9 9 9 9 9 9 9 9 9 9 5 9 9 5 9 9 9 9 5 9 5 9 5 9 5 5 5 9 9 9 9 9 9 9 9 9 9 9 9 1 1
1 1 9 9 9 9 9 9 9 9 9 5 9 9 5 9 9 9 9 5 9 5 9 5 9 5 5 5 9 9 9 9 9 9 9 9 9 9 9 9 5 9 9 5 9 9 9 9 5 9 5 9 5 9 5 5 5 9 9 9 9 9 9 9 9 9 9 9 9 5 9 9 5 9 9 9 9 5 9 5 9 5 9 5 5 5 9 9 9 9 9 9 9 9 9 9 9 9 1 1
1 1 9 9 9 9 9 9 9 9 9 5 9 9 5 9 9 9 9 5 9 5 9 5 9 5 5 5 9 9 9 9 9 9 9 9 9 9 9 9 5 9 9 5 9 9 9 9 5 9 5 9 5 9 5 5 5 9 9 9 9 9 9 9 9 9 9 9 9 5 9 9 5 9 9 9 9 5 9 5 9 5 9 5 5 5 9 9 9 9 9 9 9 9 9 9 9 9 1 1
1 1 9 9 9 9 9 9 9 9 9 5 9 9 5 9 9 9 9 5 9 5 9 5 9 5 5 5 9 9 9 9 9 9 9 9 9 9 9 9 5 9 9 5 9 9 9 9 5 9 5 9 5 9 5 5 5 9 9 9 9 9 9 9 9 9 9 9 9 5 9 9 5 9 9 9 9 5 9 5 9 5 9 5 5 5 9 9 9 9 9 9 9 9 9 9 9 9 1 1
1 1 9 9 9 9 9 9 9 9 9 5 9 9 5 9 9 9 9 5 9 5 9 5 9 5 5 5 9 9 9 9 9 9 9 9 9 9 9 9 5 9 9 5 9 9 9 9 5 9 5 9 5 9 5 5 5 9 9 9 9 9 9 9 9 9 9 9 9 5 9 9 5 9 9 9 9 5 9 5 9 5 9 5 5 5 9 9 9 9 9 9 9 9 9 9 9 9 1 1
1 1 9 9 9 9 9 9 9 9 9 5 9 9 5 9 9 9 9 5 9 5 9 5 9 5 5 5 9 9 9 9 9 9 9 9 9 9 9 9 5 9 9 5 9 9 9 9 5 9 5 9 5 9 5 5 5 9 9 9 9 9 9 9 9 9 9 9 9 5 9 9 5 9 9 9 9 5 9 5 9 5 9 5 5 5 9 9 9 9 9 9 9 9 9 9 9 9 1 1
1 1 9 9 9 9 9 9 9 9 9 5 9 9 5 9 9 9 9 5 9 5 9 5 9 5 5 5 9 9 9 9 9 9 9 9 9 9 9 9 5 9 9 5 9 9 9 9 5 9 5 9 5 9 5 5 5 9 9 9 9 9 9 9 9 9 9 9 9 5 9 9 5 9 9 9 9 5 9 5 9 5 9 5 5 5 9 9 9 9 9 9 9 9 9 9 9 9 1 1
1 1 9 9 9 9 9 9 9 9 9 5 9 9 5 9 9 9 9 5 9 5 9 5 9 5 5 5 9 9 9 9 9 9 9 9 9 9 9 9 5 9 9 5 9 9 9 9 5 9 5 9 5 9 5 5 5 9 9 9 9 9 9 9 9 9 9 9 9 5 9 9 5 9 9 9 9 5 9 5 9 5 9 5 5 5 9 9 9 9 9 9 9 9 9 9 9 9 1 1
1 1 9 9 9 9 9 9 9 9 9 5 9 9 5 9 9 9 9 5 9 5 9 5 9 5 5 5 9 9 9 9 9 9 9 9 9 9 9 9 5 9 9 5 9 9 9 9 5 9 5 9 5 9 5 5 5 9 9 9 9 9 9 9 9 9 9 9 9 5 9 9 5 9 9 9 9 5 9 5 9 5 9 5 5 5 9 9 9 9 9 9 9 9 9 9 9 9 1 1
1 1 9 9 9 9 9 9 9 9 9 5 9 9 5 9 9 9 9 5 9 5 9 5 9 5 5 5 9 9 9 9 9 9 9 9 9 9 9 9 5 9 9 5 9 9 9 9 5 9 5 9 5 9 5 5 5 9 9 9 9 9 9 9 9 9 9 9 9 5 9 9 5 9 9 9 9 5 9 5 9 5 9 5 5 5 9 9 9 9 9 9 9 9 9 9 9 9 1 1
1 1 9 9 9 9 9 9 9 9 9 5 9 9 5 9 9 9 9 5 9 5 9 5 9 5 5 5 9 9 9 9 9 9 9 9 9 9 9 9 5 9 9 5 9 9 9 9 5 9 5 9 5 9 5 5 5 9 9 9 9 9 9 9 9 9 9 9 9 5 9 9 5 9 9 9 9 5 9 5 9 5 9 5 5 5 9 9 9 9 9 9 9 9 9 9 9 9 1 1
1 1 9 9 9 9 9 9 9 9 9 5 9 9 5 9 9 9 9 5 9 5 9 5 9 5 5 5 9 9 9 9 9 9 9 9 9 9 9 9 5 9 9 5 9 9 9 9 5 9 5 9 5 9 5 5 5 9 9 9 9 9 9 9 9 9 9 9 9 5 9 9 5 9 9 9 9 5 9 5 9 5 9 5 5 5 9 9 9 9 9 9 9 9 9 9 9 9 1 1
1 1 9 9 9 9 9 9 9 9 9 5 9 9 5 9 9 9 9 5 9 5 9 5 9 5 5 5 9 9 9 9 9 9 9 9 9 9 9 9 5 9 9 5 9 9 9 9 5 9 5 9 5 9 5 5 5 9 9 9 9 9 9 9 9 9 9 9 9 5 9 9 5 9 9 9 9 5 9 5 9 5 9 5 5 5 9 9 9 9 9 9 9 9 9 9 9 9 1 1
1 1 9 9 9 9 9 9 9 9 9 5 9 9 5 9 9 9 9 5 9 5 9 5 9 5 5 5 9 9 9 9 9 9 9 9 9 9 9 9 5 9 9 5 9 9 9 9 5 9 5 9 5 9 5 5 5 9 9 9 9 9 9 9 9 9 9 9 9 5 9 9 5 9 9 9 9 5 9 5 9 5 9 5 5 5 9 9 9 9 9 9 9 9 9 9 9 9 1 1
1 1 9 9 9 9 9 9 9 9 9 5 9 9 5 9 9 9 9 5 9 5 9 5 9 5 5 5 9 9 9 9 9 9 9 9 9 9 9 9 5 9 9 5 9 9 9 9 5 9 5 9 5 9 5 5 5 9 9 9 9 9 9 9 9 9 9 9 9 5 9 9 5 9 9 9 9 5 9 5 9 5 9 5 5 5 9 9 9 9 9 9 9 9 9 9 9 9 1 1
1 1 9 9 9 9 9 9 9 9 9 5 9 9 5 9 9 9 9 5 9 5 9 5 9 5 5 5 9 9 9 9 9 9 9 9 9 9 9 9 5 9 9 5 9 9 9 9 5 9 5 9 5 9 5 5 5 9 9 9 9 9 9 9 9 9 9 9 9 5 9 9 5 9 9 9 9 5 9 5 9 5 9 5 5 5 9 9 9 9 9 9 9 9 9 9 9 9 1 1
1 1 9 9 9 9 9 9 9 9 9 5 9 9 5 9 9 9 9 5 9 5 9 5 9 5 5 5 9 9 9 9 9 9 9 9 9 9 9 9 5 9 9 5 9 9 9 9 5 9 5 9 5 9 5 5 5 9 9 9 9 9 9 9 9 9 9 9 9 5 9 9 5 9 9 9 9 5 9 5 9 5 9 5 5 5 9 9 9 9 9 9 9 9 9 9 9 9 1 1
1 1 9 9 9 9 9 9 9 9 9 5 9 9 5 9 9 9 9 5 9 5 9 5 9 5 5 5 9 9 9 9 9 9 9 9 9 9 9 9 5 9 9 5 9 9 9 9 5 9 5 9 5 9 5 5 5 9 9 9 9 9 9 9 9 9 9 9 9 5 9 9 5 9 9 9 9 5 9 5 9 5 9 5 5 5 9 9 9 9 9 9 9 9 9 9 9 9 1 1
1 1 1 1 1 1 1 1 1 1 1 1 1 1 1 1 1 1 1 1 1 1 1 1 1 1 1 1 1 1 1 1 1 1 1 1 1 1 1 1 1 1 1 1 1 1 1 1 1 1 1 1 1 1 1 1 1 1 1 1 1 1 1 1 1 1 1 1 1 1 1 1 1 1 1 1 1 1 1 1 1 1 1 1 1 1 1 1 1 1 1 1 1 1 1 1 1 1 1 1 
1 1 1 1 1 1 1 1 1 1 1 1 1 1 1 1 1 1 1 1 1 1 1 1 1 1 1 1 1 1 1 1 1 1 1 1 1 1 1 1 1 1 1 1 1 1 1 1 1 1 1 1 1 1 1 1 1 1 1 1 1 1 1 1 1 1 1 1 1 1 1 1 1 1 1 1 1 1 1 1 1 1 1 1 1 1 1 1 1 1 1 1 1 1 1 1 1 1 1 1 